011111111111111111111111
000000000000000000000001
011111111111111011111101
011111100000001011111101
011111101111111011000001
000000000000000011011101
110111101101111011011101
110111101101111011011101
110111101101000011011101
110111101101111111011101
110111101100000000011101
110000001101111111111101
111101111100000000001101
111101111111111111101100
111100000000000000001110
111111111111111111111110